XXXXXXXXXXXXXXXXXXXXXXXXXXXXXXXXXXXX
X W BBBBBGGBB     X    BBBBBBBBBB  X
X B           BBB X  B         B B X
X B BBXBBXB BX BB    B XXXXXX  B B X
X B         BB BBB B B      X BB   X
X B BBXGXBBXBBBB   BBB  B X X  B B X
X X X X     B    XX   BBB X X BB B X
X X X X     B B   BBBG    X   BBBBXX
X X   B B B    BBXXXXXXXX X B BB  XX
X XB  X     X  B X        X G     XX
X X   X    XXX BBX     G  B B BBB XX
X X BBXXX XX   BBX  BBBBB   B BB  XX
X     X   B  B BBBBG      B B BBBXXX
X BBB X  BB BBB BBXB BBBBBB    BBXXX
X B B X BBB  B  BBB  B         BBXXX
X   B X B    B BBB   B BBBB B  BBXXX
X B   XBB  BB      B B        BBBXXX
XB B   B    B B BGG    GBB  B B BXXX
XBG   B   B   B G  B B      B B   XX
XBBGB X B B B B B  B B BBB  X B   XX
XXXXB BBB B B B B BB BGB    X B X XX
XBXXBBX   B B B    B X B    X B X  X
XBBBBBX   B B B X    X BXXX X   X  X
X B BBB BB  B X    B X BXXB X B XB X
X B  BB  BB BX     B X BB   X B  B X
XBB  BBB   XB      B        X B  B X
X  XXXBXX      GB  B  BBBGBBGBBBBBBX
XB XB B   B B  X  B   B        X X X
X B B B  BBBBB X    G          X X X
X B B BB       B  B BG XGXBXB XX X X
X B XXGXBXXBXX X  B B    B B   XXX X
X B    B     X X         B B   E   X
XXXXXXXXXXXXXXXXXXXXXXXXXXXXXXXXXXXX
